EA ./path_to_the_east_texture								     
NO ./path_to_the_north_texture          			
bug here if no values are given
F   					
C 225,30,0				  	 	
WE ./path_to_the_west_texture


SO ./path_to_the_south_texture   

11111111
10100011
10100001
10101001
10000001
11100111
100N0001
11111111

11101111111111111111111111
10000000000000000000000001
10000000000000000000000001
10000000000000000000000001
10000000000000000000000001
10000000000000000000000001
10000000000000000001111111
11110111111111111111111111
   101
111001
100010
10001111111111111
11100000000000001
   11111111111011
			0101
		1111110111111111111111111
		1000000000110000000000001
		111111110110000000000001
		1001000000000000000000001
111111111011000001110000000000001
100000000011000001110111111111111
11110111111111011100000010001
11110111111111011101010010001
11000000110101011100000010001
1000000000000000110N000010001
10000000000000000001010001111
110000011101010111110111100111
11110111 1110101 101111010001
11111111 1111111 111111111111


sadhbskj ahdjkas
sadhbskjds
a 
das
dassa 
das
 ahdjkas











