NO srcs/xpms/North.xpm
SO srcs/xpms/South.xpm
WE srcs/xpms/West.xpm
C 201,204,251				      	 	
F 0116,   0000150 3,80,,,,,	,
EA srcs/xpms/East.xpm



11111111
10100011
10100001
10101001
10000001
11100111
10000001
11110111
11110111
11100111111111111111111111
10000000000000000000000001
10000000000000000000000001
100000W0000000000000000001
10000000000000000000000001
10000000000000000000000001
10000000000000000001111111
11110111111111111111111111
   101
111001
10001
10001111111111111
11100000000000001
   11111111111011
			 101
		1111110111111111111111111
		1000000000110000000000001
		111111110110000000000001
		1001000000000000000000001
111111111011000001110000000000001
100000000011000001110111111111111
11110111111111011100000010001
11110111111111011101010010001
11000000110101011100000010001
1000000000000000110000010001
10000000000000000001010001111
110000011101010111110111100111
11110111 1110101 101111010001
11111111 1111111 111111111111

    
sadhbskj ahdjkas
sadhbskjds
a 
das
dassa 
das
 ahdjkas











