NO ./assets/stone2.xpm
SO ./assets/wall1.xpm
WE ./assets/wall2.xpm
EA ./assets/wood.xpm

F 79, 59, 51
C 74,129,148

11111111111111111111111111111111111111111
10000000000000000000000000000000000000001
10000000000000000000000000000000000000001
10000000000000000000000000000000000000001
10000011111000010101000111111111111111111
100000100010000000000001
100000100010000100010001
100000100010000000000001
100000110110000101010001
100000000000000000000001
100000000000000000000001
100000000000000000000001
100000000000000000000001
100000000000000000000001
100000000000000000000001
100000000000000000000001
111111111000000000000001
110100001000000000000001
110000101000000000000001
110100001000000N00000001
110111111000000000000001
110000000000000000000001
111111111000000000000001
111111111111111111111111
