NO assets/stone2.xpm
SO assets/wall1.xpm
WE assets/wall2.xpm
EA assets/wood.xpm

F 220,100,0
C 225,30,0

        1111111111111111111111111
        1000000000110000000000001
        1011000001110000000000001
        1001000000000000000000001
 11111111011000001110000000000001
10000000001100000111011111111111
11110111111111011100000010001
11110111111111011101010010001
11000000110101011100000010001
00000000000000001100000010001
10000000000000001101010010001
11000001110101011111011010N0111
11110111 1110101 101111000001
 1111111 1111111 11111111111
